NO ./brick1.jpg
SO ./brick2.png
WE ./brick3.jpg
EA ./brick4.jpg


F 0,32,0
C 120,0,16

       1111111111111111111111111
       1000000000110000000000001
       1011000001110000000000001
       1111111111111111111111111
