NO ./textures/brick_n.png
SO ./textures/brick_s.png
WE ./textures/brick_w.png
EA ./textures/brick_e.png

F 220,100,0

1111
10N1
1111

C 225,30,0