NO ./brick_n.png
SO ./brick_s.png
WE ./brick_w.png
EA ./brick_e.png


F 120,32,3
C 120,0,16

        1111111111111111111111111
        1000000000110000000000001
        1011000001110000000000001
        1001000000000000000000001
111111111011000001110000000000001
100000000011000001110111110111111
11110111111111011100000010001
11110111111111011101010010001
11000000110101011111111110001
100000000000000011     110001
10000000000000001111111110001
1100000111010101111101111N0111
11110111 1110101 101111010001
11111111 1111111 111111111111

