F 4,112,73
C 52,134,235


NO ./brick_n.png
SO ./brick_s.png
WE ./brick_w.png
EA ./brick_e.png

11111111111111111111
1E000000000000000001
10000000000000000001
10011001100111111001
10011001100000011001
10011111100111111001
10000001100110000001
10000001100111111001
10000000000000000001
10000000000000000001
11111111111111111111