
F 4,112,73


C 52,134,235
NO ./textures/brick_n.png


SO ./textures/brick_s.png


WE ./textures/brick_w.png

EA ./textures/brick_e.png





                        1111111111111111111111111       
                        1000000000110000000000001
                        1011000001110000000000001
                        1001000000000000000000001
                111111111011000001110000000000001
                100000000011000001110111110111111
                11110111111111011100000010001
                11110111111111011101010010001
                11000000110101011100000011111
                10000000000000001100000010001
                10N00000000000001101010011111
                1100000111010101111101111001111
                11110111 1110101 101111010  111
                11111111 1111111 111111111111
