
F 4,112,73
C 52,134,235


NO ./brick_n.png
SO ./brick_s.png


WE ./brick_w.png
EA ./brick_e.png


        11111
    11111N011
        1111
