
F 4,112,73
C 52,134,235


NO ./brick_n.png
SO ./brick_s.png


WE ./brick_w.png
EA ./brick_e.png



         1111111111111111111111111
        100000000011000000000000001
        101100000111000000000000001
        100100000000000000000000001
111111111011000001110000000000000W1
1000000000110000011101111101111111
11110111111111011100000010001
11110111111111011101010010001
11000000110101011100000000001
10000000000000001100000010001
10000000000000001101010010001
1100000111010101111101111000111
11110111 1110101 101111010001
11111111 1111111 111111111111

