
F 4294967299,112,73
C 52,134,235


NO ./brick_n.png
SO ./brick_s.png


WE ./brick_w.png
EA ./brick_e.png



                        1111111111111111111111111
                        1000000000110000000000001
                        1011000001110000000000001
                        1001000000000000000000001
                111111111011000001110000000000001
                100000000011000001110111110111111
                11110111111111011100000010001
                11110111111111011101010010001
                11001000110101011100000000001
                1000W100000000110000001000001
                10001000000000011010100100001
                1100000111010101111101111000111
                11110111 1110101 101111010001
                11111111 1111111 111111111111
